#.......#.......
..##.#.###...p..
p.#....#........
#....#.....##...
#..#####.#..##..
....##....#..###
.#....#.##..#...
##..#.......#.#.
.##.##.#.#.#...#
........##...#..
.#.#...##...###.
.#...#.####.###.
...#..........#.
#.##.#.###....@.
..#..#.#........
#...@......#####