#...............
..##.#.###...p..
p.#....#........
#....#.#...##...
#..#####....##..
................
.#......##......
.#..#...........
.##.##.#.#......
........##......
.#.....##...###.
.#.....##...###.
..............#.
..##.#.###....@.
..#..#.#........
#...@...........
