##......##......
.#..@..##...###.
.#.....##...###.
..............#.
..##.#.###.##...
..#..#.#........
#...#...#...####
..............#.
..##.#.###...#..
..#...p#...#....
#....#.#...##..#
#..#####....##..
.....#......#..#
.#......##......
p#..#...@...###.
.##.##.#.#.....#
