##......##......
.#.....##...###.
.#.....##...###.
..............#.
..##.#.###....@.
..#..#.#........
#...@...........
................
..##.#.###......
..#...p#........
#....#.#...##..#
#..#####....##..
................
.#......##......
p#..#...........
.##.##.#.#......
