...#..#p........
.....##........#
..#....#..#.#.#.
..#.##.#...##...
.@#......#....#.
.@##.#######.##.
#..#.#...#...#..
.#.#........##.#
.#.###.##.......
.......#....#...
####..#...#####.
...#.....#.....#
.#...####....#..
..###.######.#.#
#.##.....#...#..
.....#.#...#.#p.
