@..#..#p........
.....##.........
..#....#........
..#.##.#........
..#.............
..##.#######.##.
#..#.#.......#..
@#.#........##.#
.#.###.##.......
.......#....#...
####.#.#...#####
...#.#....#.....
.#...#####....#.
..####.######.#.
#.##.#...#....#.
.......#...#.#p.
