#####....#######
.@..#....#.p..##
##..#....###..##
##..#......#..##
##..#......#..##
##..#.#..#.#..##
##..#......#..##
##..#......#...#
#...#.#..#.#..##
##..#..##..#..##
##..#......#..##
##..#......#..##
##..#......#.###
##..###....#..##
###.p.#....#..@.
#######....#####
